11111111111111111111111111
1E0000000000000000000000P1
10000000000000000000000001
10111101111111111111111111
100C10000000000000000000C1
11011111011111110111111111
10C00C10000000C100000000C1
11111110111111111110111111
1C00000000001C000000000C01
11111111111111111111111111