111111111111111
1C00100000000E1
111010000010111
1P0000000010C01
111111111111111