111111111111111111111
10C0000000000000000C1
101111111000111111111
10000C1000P00000000E1
101111111000111111111
1000000C10000000000C1
111111111111111111111