11111111111111111111111
1C001000E00000100C10001
1110100P0010111001C0101
1000000C001C000000001C1
11111111111111111111111